Suppose - предпологать
Soon - скоро
Determine - решит
Responsibility - отвественность
Revenge - месть
Claim - требовать
Ever - когда либо
Guess - угадывать
Folks - близкие
Strangers - незнакомцы
Chase - выгонять
Dizzy - головокружение
Cause - причина
Seem - казаться
Fit - соответсвовать
Grab - схватить
Cheat - обманывать
Handle - держать в руках
Obviously - очевидно
Unfortunately - к несчастью
No doubt - без сомнения
Almost - почти
Against - против
Define - определять
Certain - определенно
Mankind - человечество
Struck - ударил
Expect - ожидание
Disaster - катастрофа
Enough - достаточно
Afraid - испуганный
Consequences - последствия
Ugly - некрасивый
Bother - бесит
Regret - сожалеть
Few - мало
Carry out - выполнять
Carry - нести
Prefer - предпологать
Confident - уверенный
Rather - достаточно
Abroad - за границу
Arrange - организовать
Necessary - обязательный
Be aware - будь в курсе
Reduce - сокращать
Compare - сравнивать
Each other - друг с другом
I must admit - я должен признать
Tricky - хитрый
Tends to - как правило обычно
Fear - страх
Survive - выжить
Either - либо
Sample - проба
Wipe - вытирать
Instead - вместо
Envy - завидовать
Hurry - торопиться
Suggest - советовать
Confirm - подтверждать
Direct - прямой управлять
Rush - спешка
Suddenly - внезапно
Holy - святой
Blow - дуть
Emerging - начинающий
Worth - ценность
Capacity - способность вместимость
Bury - хоронить
Purge - отчищать
Mess - беспорядок
Difinitly - определенно несомненно
Below - под
Through - через
Them - их
Meant - иметь в виду
Conventions - соглашение
Statement - заявление
Environment - среда окружение
Execute - выполнять
Seed - семена
Propose - предлогать
Naked - голый
Assignment - назначение
Require - требовать
Explicit - точный
Parenttheses - скобки
Braces - скобки
Instead - взамен
Obtained - получено
Common - обычный
Compare - сравнивать
Cofused - перепутал